

　　　★★★★★★★★★★★★★★★★★★★★★★★★★
　　　★　　　　　　　　　　　　　　　　　　　　　　　★
　　　★　　　　　　★★　西　游　记　★★　　　　　　★
　　　★　　　　　　　　　　　　　　　　　　　　　　　★
　　　★　Ａ　Ｊｏｕｒｎｅｙ　ｔｏ　ｔｈｅ　Ｗｅｓｔ　★
　　　★　　　　　　　　　　　　　　　　　　　　　　　★
　　　★★★★★★★★★★★★★★★★★★★★★★★★★
	
　　　　　　　　　★★　西游记4.5版本　★★
